NO ./img/text_rock.xpm
SO ./img/crane.xpm
WE ./img/earth.xpm
EA ./img/wood.xpm
F 0,50,50
C 50,50,0


        1111111111111111111111111
        1000000000110000000000001
        1011000001110000000000001
        10010000000D0000000000001
111111111011000001110000000000001
10000000001100000111D1111D1111111
11110111111111D11100000010001
1111011111111111 101010010001
11000000110101111100000010001
10000000000000000D000000D00010
10000000000000001101010011101
1100000111011011111011110N111 
11110111 1110101 101111011101
    1       1 1   1    1 111

1
1