NO ./img/text_rock.xpm
SO ./img/crane.xpm
WE ./img/earth.xpm
EA ./img/wood.xpm
C 30,30,30
F 0,300,60

111111111111111111111111111111111
100DDDDDD000000000110000000000001
111111111011000001110000000000001
        10010000000D000000N0000001
111111111011000001110000000000001
100000000011000001110D0D0D1111111
11110111111111D11100000010001
11110111111111011101010010001
11000000110101011100000010001
10000000000000000D000000D0001
10000000000000001101010010001
110000011101101111101111000111
11110111 1110101 101111010001
11111111 1111111 11111111111